11111111111111111111111111
10P00C00C0000E000000000001
10000000000000000000000001
10000000000000000000000001
10000000000000000000000001
11111111111111111111111111